%%%%%%%%%%%%
%        24%
%      %%%%%
%%%%%      %
%13     o  %
%%%%%%%%%%%%